10 20 0
####################
#a****%*********%**#
######## %     $   #
# $ D***********   #
######     ####  ###
#******** **       #
####D           &  #
#  $ D######       #
#    $$    *    ?  #
####################